R 1280 720
   
S ./imgs/1.xpm
F 220,100,0
C 225,30,0
NO ./imgs/zadornov.xpm


SO ./imgs/kit.xpm
EA ./imgs/rjekich2.xpm

WE ./imgs/rjekich1.xpm





     1111111111111111
111111  11000001
1E00001100011021
110000000000011
1 112000000001
1100000011111
1000220000001
1111111111111

